ALERT=HEI! Voisinko saada huomiosi?
ARDUINONOTCONNECTED=Ongelma arduinon yhteysportissa, tarkista liitäntä.
BADMRLCOMMVERSION=Arduinossa on vanhentunut MRL- versio, ole hyvä ja päivitä MRL- ohjelmisto.
BADSHUTDOWN=Huomio! Aivoni ovat vioittuneet, käynnistäisitkö minut uudelleen. Älä huoli palautan tiedostot.
CHATBOTACTIVATED=Keskustelubotti ladattu, käynnistän myös muita komponentteja, odota hetki.
CHATBOTERROR=Keskustelubottia ei voinut käynnistyä koska kielitiedostoa ei löytynyt.
CHATBOTLOADING=Alustetaan aivolohkot, odota hetki.
MOUTHSYNCRONISATION=Automaattinen äänisignaaliin perustuva suun synkronointi.
MOUTHSYNCRONISATIONBAD=Analogisesta portista ei havaittu yhtään hyvää äänisignaalia,
MOUTHSYNCRONISATIONNOTPERFECT=Tunnistin äänisignaalin, mutta se ei ole täydellinen, Tarkistaisitko arduinon kytkennän.
MOUTHSYNCRONISATIONOK=Hienoa, katso huuliani, ne vaikuttaisivat liikkuvan.
NEOPIXELNOWORKY=Ongelma neopixelsin kanssa, tarkista liitäntä ja mrl- ohjelmiston asetukset.
OPENCVNOWORKY=Ongelma. Open Ceve ei voi käynnistyä.
OPENNINOWORKY=Ongelma. Kinetic ei voi käynnistyä. Tarkista Microsoftin kinetic liitäntä.
READY=Ok, sinulla on minun huomioni
SHUTDOWN=Sammutan järjestelmän, odota 10 sekuntia.
STARTINGEAR=Alustetaan korvat.
STARTINGEYELIDS=Aloittaminen silmäluomien
STARTINGHEAD=Alustetaan pää.
STARTINGLEFTARM=Alustetaan vasemmanpuoleinen käsivarsi.
STARTINGLEFTHAND=Alustetaan vasemmanpuoleinen kämmen.
STARTINGMOUTH=Alustetaan suu.
STARTINGNEOPIXEL=Aloita neopikselipalvelu
STARTINGOPENCV=avaa c.v. kamera, valmis
STARTINGOPENNI=Kinect, aloitettu
STARTINGPIR=p, i, r anturin aktivointi
STARTINGRIGHTARM=Oikean käden aloitus
STARTINGRIGHTHAND=Oikeanpuoleinen käsi
STARTINGROLLNECK=Aloita telan kaula
STARTINGTORSO=Alustetaan vartalo.
STARTINGULTRASONIC=Ultrasonic anturi aktivoitu.
STARTINGVIRTUAL=virtuaalinen inmoov aktivoitu
TRACKINGSTARTED=Seurantatoiminto aktivoitu.
